{
	"width": 8,
	"height": 5,
	"box": [
		"W   r", "B    ", "B 1  ", "B 2  ", "B 3  ", "B 4  ", "     ", "B    ",
		"     ", "     ", "P    ", "     ", "     ", "     ", "     ", "     ",
		"     ", "     ", "     ", "     ", "W  a ", "P    ", "     ", "     ",
		"W   g", "B    ", "Bcccc", "Bdd  ", "B    ", "B    ", "B    ", "W g  ",
		"B    ", "     ", "     ", "     ", "B    ", "Ba   ", "     ", "     ",
	],
	"floor": [
		"     ", "     ", "     ", "     ", "     ", "     ", "     ", "     ",
		"     ", "     ", "     ", "     ", "     ", "     ", "     ", "     ",
		"     ", "     ", "     ", "     ", "     ", "     ", "     ", "     ",
		"     ", "     ", "     ", "     ", "     ", "T    ", "     ", "     ",
		"     ", "     ", "     ", "     ", "     ", "     ", "     ", "     ",
	],
}
