{
	"width": 8,
	"height": 5,
	"box": [
		"W   r", "     ", "     ", "     ", "     ", "     ", "     ", "W b  ",
		"     ", "     ", "B g g", "     ", "B    ", "     ", "     ", "     ",
		"     ", "     ", "     ", "P  b ", "     ", "     ", "     ", "     ",
		"     ", "     ", "     ", "     ", "B    ", "     ", "     ", "     ",
		"W   r", "     ", "     ", "     ", "     ", "     ", "     ", "W    ",
	],
	"floor": [
		"     ", "     ", "     ", "     ", "     ", "     ", "     ", "     ",
		"     ", "     ", "     ", "     ", "     ", "     ", "     ", "     ",
		"     ", "     ", "     ", "     ", "     ", "     ", "     ", "     ",
		"     ", "     ", "     ", "     ", "     ", "T    ", "     ", "     ",
		"     ", "     ", "     ", "     ", "     ", "     ", "     ", "     ",
	],
}
