{
	"width": 8,
	"height": 5,
	"box": [
		"W    ", "B rr ", "B    ", "B    ", "B    ", "B    ", "     ", "B    ",
		"     ", "     ", "P    ", "     ", "     ", "     ", "     ", "     ",
		"     ", "     ", "     ", "     ", "W    ", "P  b ", "     ", "     ",
		"W    ", "B   r", "B  r ", "Bg   ", "B g  ", "B    ", "B    ", "W    ",
		"B    ", "     ", "     ", "     ", "B    ", "B    ", "     ", "     ",
	],
	"floor": [
		"     ", "     ", "     ", "     ", "     ", "     ", "     ", "     ",
		"     ", "     ", "     ", "     ", "     ", "     ", "     ", "     ",
		"     ", "     ", "     ", "     ", "     ", "     ", "     ", "     ",
		"     ", "     ", "     ", "     ", "     ", "T    ", "     ", "     ",
		"     ", "     ", "     ", "     ", "     ", "     ", "     ", "     ",
	],
}
