{
	"width": 8,
	"height": 5,
	"box": [
		"W   r", "B    ", "B 1  ", "B 2  ", "B 3  ", "B 4  ", "     ", "     ",
		"     ", "     ", "     ", "     ", "     ", "     ", "     ", "     ",
		"     ", "     ", "     ", "     ", "W  a ", "P    ", "     ", "     ",
		"W   g", "B    ", "B    ", "B    ", "B    ", "B    ", "B    ", "W g  ",
		"     ", "     ", "     ", "     ", "B    ", "Ba   ", "     ", "     ",
	],
	"floor": [
		"     ", "     ", "     ", "     ", "     ", "     ", "     ", "     ",
		"     ", "     ", "     ", "     ", "     ", "     ", "     ", "     ",
		"     ", "     ", "     ", "     ", "     ", "     ", "     ", "     ",
		"     ", "     ", "     ", "     ", "     ", "T    ", "     ", "     ",
		"     ", "     ", "     ", "     ", "     ", "     ", "     ", "     ",
	],
}
